11,0,0,14,0,11,0,0,29,0,11,0,11,0,15,0,11
27,28,29,76,26,27,28,76,0,26,27,26,27,28,11,26,27
43,0,91,92,93,43,91,92,93,0,43,0,43,26,27,28,43
15,29,107,108,109,47,107,108,109,0,0,14,0,11,43,15,11
0,46,101,103,102,51,101,103,102,104,0,29,26,27,28,26,27
0,0,0,84,0,0,0,84,0,0,0,0,0,43,0,0,43
84,84,84,84,84,84,84,84,84,84,84,84,84,84,84,84,84
14,0,0,0,0,0,29,0,0,14,0,0,0,14,0,0,29
